EA textures/east_wall.xpm
NO textures/north_wall.xpm
SO textures/south_wall.xpm
WE textures/west_wall.xpm


F 20,20,00
C 119,181,154

1111111111111111111111111111
10000000000000000N0000000001
1000000000000000000000000001
10000000000000000000000000001
1000000000000000000001000001
1000000000000000000000100001
1000000000000000000000000001
1000000000000000000000000001
1000000000000000000000000001
1000000000000000000000000001
1111111111111111111111111111