SO ./textures/south_wall.xpm
EA ./textures/east_wall.xpm
NO ./textures/north_wall.xpm
WE ./textures/west_wall.xpm

F 255,255,0
C 3, 26, 173

1111111111111111111111111
1000000000110000000000001
101100S001110000000000001
100100000000000000000000111111111
100100000000000000000000111111111
100100000000000000000000111111111
100100000000000000000000111111111
100100000000000000000000111111111
100100000000000000000000111111111
100100000000000000000000111111111
100100000000000000000000111111111
100100000000000000000000111111111
100100000000000000000000111111111
100100000000000000000000111111111
100100000000000000000000111111111
100100000000000000000000111111111
100100000000000000000000111111111
100100000000000000000000111111111
100100000000000000000000111111111
100100000000000000000000111111111
100100000000000000000000111111111
100100000000000000000000111111111
100100000000000000000000111111111
111111111011000001110000000000001
100000000011000001110111111111111
1100000111010101111101111000111
11110111 1110101 101111010001
11111111 1111111 111111111111
