SO ./textures/south_wall.xpm
EA ./textures/east_wall.xpm
NO ./textures/north_wall.xpm
WE ./textures/west_wall.xpm

F 6, 254, 79
C 3, 26, 173

        1111111111111111111111111
        100D000000110000000000001
        1011000001110000000000001
        1001000000D0001D111100001
111111111011000001110010000010001
10000000001100000111D111111D11111
111101111111D1011100000010001
1111D100000001D11101010010001
11000000110000011100000010001
10000000000000000D000000D00011
1000000000000000010101001W00111
110000011101010111100111100011
11110111 1110101 101111010001
11111111 1111111 11111111111