SO ./textures/south_wall.xpm
EA ./textures/east_wall.xpm
NO ./textures/north_wall.xpm
WE ./textures/west_wall.xpm

F 255,255,0
C 3, 26, 173

        1111111111111111111111111
        100D000000110000000000001
        1011000001110000000000001
        1001000000D00000000000001
111111111011000001110000000100001
10000000001100000111DD11111111111
11110111111111011100000010001
1111D111111111D11101010010001
11000000110101011100000010001
10000000000000000D000000D0001
1000000000000000010101001W0011111
11000001110101011111011110001
11110111 1110101 101111010001
11111111 1111111 11111111111